#########################
#       # # #         # #
# # ### # # # ### ##### #
# # # # #       #       #
### # # # # #############
#     #   #         #   #
### # # # # ### ##### # #
#   # # # #   #       # #
# # # # ### ### ### #####
# # # # # #   #   #     #
# # # ### ###############
# # #                   #
# # ### ####### ####### #
# #   #       #       # #
# # ### # ########### # #
# # #   #   #       # # #
# # # # # # # # #########
# # # # # #   #     # # #
# # ### # # ####### # # #
# # #   # #       #   # #
# ### # # ############# #
# #   # #               #
# # # ### # ######### ###
# # # #   #       #     #
#########################
