#############
#     #     #
# ##### # ###
#       #   #
### #########
#           #
# ### ### ###
# #     #   #
# ### ### ###
#   #   #   #
### # ### # #
#   #   # # #
#############
